"","Variable","Jan","Feb","Mar","Q1","Apr","May","Jun","Q2","Jul","Aug","Sep","Q3","Oct","Nov","Dec","Q4","Total","Physical Turnout","Group","Subgroup","Name","Section","Year"
"1","TOTAL CUSTOMER DELIVERIES","64252","66697","139065","270014","171027","154487","181099","506613","167843","192047","142420","502310","103812","71171","66662","241645","1520582",NA,"TOTAL CUSTOMER DELIVERIES",NA,NA,"TOTAL CUSTOMER DELIVERIES",2008
"2","WATER BANK DELIVERIES ***","7874","9073","12364","29311","8611","8457","10744","27812","11770","50702","34758","97230","19009","16442","27186","62637","216990",NA,"WATER BANK DELIVERIES ***",NA,NA,"TOTAL CUSTOMER DELIVERIES",2008
"3","TOTAL CANAL LOSSES","739","1283","2185","4207","2959","3425","3464","9848","3382","2663","2559","8604","2343","1892","1423","5658","28317",NA,"TOTAL CANAL LOSSES",NA,NA,"TOTAL CUSTOMER DELIVERIES",2008
"4","MWD LAKE STORAGE THRU T/O","0","1067","3472","4539","3894","4164","3434","11492","2383","3252","3642","9277","4947","4047","511","9505","34813",NA,"MWD LAKE STORAGE THRU T/O",NA,NA,"TOTAL CUSTOMER DELIVERIES",2008
"5","SRP/CAP EXCHANGE WATER","0","0","0","0","0","0","0","0","0","0","0","0","0","0","0","0","0",NA,"SRP/CAP EXCHANGE WATER",NA,NA,"TOTAL CUSTOMER DELIVERIES",2008
"6","SALT RIVER PROJECT/XS ($6/AF)","0","0","0","0","0","0","0","0","0","0","0","0","0","0","0","0","0",NA,"SALT RIVER PROJECT/XS ($6/AF)",NA,NA,"TOTAL CUSTOMER DELIVERIES",2008
"7","WADDELL PUMPING","99649","88679","23780","212108","0","18160","769","18929","0","0","0","0","25846","91045","20663","137554","368591",NA,"WADDELL PUMPING",NA,NA,"TOTAL CUSTOMER DELIVERIES",2008
"8","WADDELL RELEASES","0","0","-81","-81","-11920","-8248","-60264","-80432","-92679","-129383","-54211","-276273","-1553","0","-22642","-24195","-380981",NA,"WADDELL RELEASES",NA,NA,"TOTAL CUSTOMER DELIVERIES",2008
"9","COLORADO RIVER DIVERSIONS","164640","157726","168421","490787","165960","171988","128502","466450","80929","68579","94410","243918","135395","168155","66617","370167","1571322","Forbearance of 25kaf as Recovery for MWD","COLORADO RIVER DIVERSIONS",NA,NA,"TOTAL CUSTOMER DELIVERIES",2008
"10","COLORADO RIVER ACTUAL","166725","157301","167973","491999","165730","172183","126311","464224","78041","65373","93513","236927","135834","167966","64769","368569","1561719",NA,"COLORADO RIVER ACTUAL",NA,NA,"TOTAL CUSTOMER DELIVERIES",2008
"11","TOTAL CUSTOMER DELIVERIES","75118","74798","130852","280768","152838","168705","181604","503147","193066","201282","134258","528606","117993","57939","94280","270212","1582733",NA,"TOTAL CUSTOMER DELIVERIES",NA,NA,"TOTAL CUSTOMER DELIVERIES",2009
"12","WATER BANK DELIVERIES ***","5720","2000","2500","10220","10408","14871","21188","46467","18064","21284","6303","45651","2378","378","924","3680","106018",NA,"WATER BANK DELIVERIES ***",NA,NA,"TOTAL CUSTOMER DELIVERIES",2009
"13","TOTAL CANAL LOSSES","739","1283","2185","4207","2959","3425","3464","9848","3382","2663","2559","8604","2343","1892","1423","5658","28317",NA,"TOTAL CANAL LOSSES",NA,NA,"TOTAL CUSTOMER DELIVERIES",2009
"14","MWD LAKE STORAGE THRU T/O","0","637","3343","3980","2738","3244","2609","8591","3010","2870","2972","8852","4607","4045","599","9251","30674",NA,"MWD LAKE STORAGE THRU T/O",NA,NA,"TOTAL CUSTOMER DELIVERIES",2009
"15","SRP/CAP EXCHANGE WATER","-837","-1677","-1246","-3760","-5393","-2494","-6596","-14483","-5100","-9040","-7990","-22130","-6356","-2699","-4384","-13439","-53812",NA,"SRP/CAP EXCHANGE WATER",NA,NA,"TOTAL CUSTOMER DELIVERIES",2009
"16","SALT RIVER PROJECT/XS ($6/AF)","0","0","0","0","0","0","0","0","0","0","0","0","0","0","0","0","0",NA,"SALT RIVER PROJECT/XS ($6/AF)",NA,NA,"TOTAL CUSTOMER DELIVERIES",2009
"17","WADDELL PUMPING","97686","85428","45817","228931","20571","4193","0","24764","0","0","20940","20940","17280","77414","58224","152918","427553",NA,"WADDELL PUMPING",NA,NA,"TOTAL CUSTOMER DELIVERIES",2009
"18","WADDELL RELEASES","0","0","0","0","0","-12106","-84124","-96230","-118289","-126218","-9314","-253821","0","0","0","0","-350051",NA,"WADDELL RELEASES",NA,NA,"TOTAL CUSTOMER DELIVERIES",2009
"19","COLORADO RIVER DIVERSIONS","172706","160469","180951","514126","173713","164967","96957","435637","76069","71557","143425","291051","135867","138591","150142","424600","1665414","Forbearance of 27.5kaf as Recovery for MWD 27.5kaf, ","COLORADO RIVER DIVERSIONS",NA,NA,"TOTAL CUSTOMER DELIVERIES",2009
"20","COLORADO RIVER ACTUAL","171343","162340","180297","513980","172325","164730","93568","430623","74956","70375","143343","288674","133109","143938","149484","426531","1659808","msidd  11kaf, caidd  11kaf, hid  5kaf  (backed out of ag supply)","COLORADO RIVER ACTUAL",NA,NA,"TOTAL CUSTOMER DELIVERIES",2009
"21","TOTAL CUSTOMER DELIVERIES","56674","56869","103819","217362","153932","165117","206179","525228","216826","191448","167554","575828","106439","82263","83779","272481","1590899",NA,"TOTAL CUSTOMER DELIVERIES",NA,NA,"TOTAL CUSTOMER DELIVERIES",2010
"22","WATER BANK DELIVERIES ***","5364","4720","14032","24116","15168","22954","24691","62813","23257","20143","22834","66234","21776","11430","6343","39549","192712",NA,"WATER BANK DELIVERIES ***",NA,NA,"TOTAL CUSTOMER DELIVERIES",2010
"23","TOTAL CANAL LOSSES","739","1283","2185","4207","2959","3425","3464","9848","3382","2663","2559","8604","2343","1892","1423","5658","28317",NA,"TOTAL CANAL LOSSES",NA,NA,"TOTAL CUSTOMER DELIVERIES",2010
"24","MWD LAKE STORAGE THRU T/O","0","1104","801","1905","2490","3757","3774","10021","2924","1975","2969","7868","3073","4050","845","7968","27762",NA,"MWD LAKE STORAGE THRU T/O",NA,NA,"TOTAL CUSTOMER DELIVERIES",2010
"25","SRP/CAP EXCHANGE WATER","0","0","0","0","-302","-47","-1169","-1518","-1176","-1372","-1426","-3974","-1639","-962","-1446","-4047","-9539",NA,"SRP/CAP EXCHANGE WATER",NA,NA,"TOTAL CUSTOMER DELIVERIES",2010
"26","SALT RIVER PROJECT/XS ($6/AF)","825","1214","0","2039","0","0","0","0","0","0","830","830","1510","0","321","1831","4700",NA,"SALT RIVER PROJECT/XS ($6/AF)",NA,NA,"TOTAL CUSTOMER DELIVERIES",2010
"27","WADDELL PUMPING","69254","32024","23237","124515","0","794","0","794","0","0","15215","15215","55015","64395","104913","224323","364847",NA,"WADDELL PUMPING",NA,NA,"TOTAL CUSTOMER DELIVERIES",2010
"28","WADDELL RELEASES","0","0","0","0","-5265","-2361","-39965","-47591","-167728","-106895","-18499","-293122","0","0","0","0","-340713",NA,"WADDELL RELEASES",NA,NA,"TOTAL CUSTOMER DELIVERIES",2010
"29","COLORADO RIVER DIVERSIONS","126667","91280","130042","347989","153814","170685","172283","496782","54228","87819","168372","310419","165231","151638","189514","506383","1661573","Forbearance of 8.1kaf as ICUA Recovery for MWD. Orig 1.588 maf for AZ + anticipating 30kaf Nev unused apportionment","COLORADO RIVER DIVERSIONS",NA,NA,"TOTAL CUSTOMER DELIVERIES",2010
"30","COLORADO RIVER ACTUAL","126294","90880","128306","345480","153154","171813","170755","495722","49808","84097","170650","304555","165628","158820","182563","507011","1652768",NA,"COLORADO RIVER ACTUAL",NA,NA,"TOTAL CUSTOMER DELIVERIES",2010
"31","TOTAL CUSTOMER DELIVERIES","66498","78366","135796","280660","151715","177404","223913","553032","229857","215585","138247","583689","90308","48560","60098","198966","1616347",NA,"TOTAL CUSTOMER DELIVERIES",NA,NA,"TOTAL CUSTOMER DELIVERIES",2011
"32","TOTAL CANAL LOSSES","739","1283","2185","4207","2959","3425","3464","9848","3382","2663","2559","8604","2343","1892","1423","5658","28317",NA,"TOTAL CANAL LOSSES",NA,NA,"TOTAL CUSTOMER DELIVERIES",2011
"33","MWD LAKE STORAGE THRU T/O","0","1539","3357","4896","4557","5249","4832","14638","5186","4567","3615","13368","3951","3560","916","8427","41329",NA,"MWD LAKE STORAGE THRU T/O",NA,NA,"TOTAL CUSTOMER DELIVERIES",2011
"34","SRP/CAP EXCHANGE WATER","0","0","0","0","0","0","0","0","0","0","0","0","0","0","70","70","70",NA,"SRP/CAP EXCHANGE WATER",NA,NA,"TOTAL CUSTOMER DELIVERIES",2011
"35","WADDELL PUMPING","22743","52608","44419","119770","21347","7072","1045","29464","316","0","4936","5252","51830","121619","87741","261190","415676",NA,"WADDELL PUMPING",NA,NA,"TOTAL CUSTOMER DELIVERIES",2011
"36","WADDELL RELEASES","0","0","0","0","0","-25965","-77908","-103873","-159336","-161275","-46169","-366780","0","0","0","0","-470653",NA,"WADDELL RELEASES",NA,NA,"TOTAL CUSTOMER DELIVERIES",2011
"37","COLORADO RIVER DIVERSIONS","89980","133796","185757","409533","180578","167185","155346","503109","79405","61540","103188","244133","148432","175631","150248","474311","1631086","No ICUA Forbearance in 2011, MWD recovery complete.","COLORADO RIVER DIVERSIONS",NA,NA,"TOTAL CUSTOMER DELIVERIES",2011
"38","COLORADO RIVER ACTUAL","89029","134563","186159","409751","180434","166473","154609","501516","76895","60168","101762","238825","149410","174986","150555","474951","1625043",NA,"COLORADO RIVER ACTUAL",NA,NA,"TOTAL CUSTOMER DELIVERIES",2011
"39","TOTAL CUSTOMER DELIVERIES","71862","97013","138394","307269","173973","190845","207776","572594","174557","175287","133433","483277","101903","59004","74452.000000000015","235359","1598499",NA,"TOTAL CUSTOMER DELIVERIES",NA,NA,"TOTAL CUSTOMER DELIVERIES",2012
"40","TOTAL CANAL LOSSES","739","1283","2185","4207","2959","3425","3464","9848","3382","2663","2559","8604","2343","1892","1423","5658","28317",NA,"TOTAL CANAL LOSSES",NA,NA,"TOTAL CUSTOMER DELIVERIES",2012
"41","MWD LAKE STORAGE THRU T/O","0","2973","4033","7006","4005","5449","4499","13953","2651","3116","3139","8906","3227","3812","1548","8587","38452",NA,"MWD LAKE STORAGE THRU T/O",NA,NA,"TOTAL CUSTOMER DELIVERIES",2012
"42","SRP/CAP EXCHANGE WATER","-267","-578","-1487","-2332","-2176","-1120","-4972","-8268","-3294","0","0","-3294","-344","-654","-193","-1191","-15085",NA,"SRP/CAP EXCHANGE WATER",NA,NA,"TOTAL CUSTOMER DELIVERIES",2012
"43","WADDELL PUMPING","111219","67581","44397","223197","6884","1498","0","8382","0","0","4628","4628","9922","109236","56385","175543","411750",NA,"WADDELL PUMPING",NA,NA,"TOTAL CUSTOMER DELIVERIES",2012
"44","WADDELL RELEASES","0","0","0","0","-4241","-19505","-79570","-103316","-137316","-94470","-6379","-238165","-85065","0","0","-85065","-426546",NA,"WADDELL RELEASES",NA,NA,"TOTAL CUSTOMER DELIVERIES",2012
"45","COLORADO RIVER DIVERSIONS","183553","168272","187522","539347","181404","180592","131197","493193","39980","86596","137380","263956","31986","173290","133980","339256","1635752",NA,"COLORADO RIVER DIVERSIONS",NA,NA,"TOTAL CUSTOMER DELIVERIES",2012
"46","COLORADO RIVER ACTUAL","186564","168959","187497","543020","179531","179210","129951","488692","34437","85226","136910","256573","31581","173912","132284","337777","1626062",NA,"COLORADO RIVER ACTUAL",NA,NA,"TOTAL CUSTOMER DELIVERIES",2012
"47","TOTAL CUSTOMER DELIVERIES","50994","53487","105997","210478","176631","187821","210914","575366","179001","179261","118144","476406","105253","59424","93077","257754","1520004",NA,"TOTAL CUSTOMER DELIVERIES",NA,NA,"TOTAL CUSTOMER DELIVERIES",2013
"48","TOTAL CANAL LOSSES","739","1283","2185","4207","2959","3425","3464","9848","3382","2663","2559","8604","2343","1892","1423","5658","28317",NA,"TOTAL CANAL LOSSES",NA,NA,"TOTAL CUSTOMER DELIVERIES",2013
"49","MWD LAKE STORAGE THRU T/O","0","2171","3910","6081","5152","5526","5209","15887","3458","2691","2136","8285","3957","2555","111","6623","36876",NA,"MWD LAKE STORAGE THRU T/O",NA,NA,"TOTAL CUSTOMER DELIVERIES",2013
"50","SRP/CAP EXCHANGE WATER","0","0","0","0","0","0","-11007","-11007","-6524","0","0","-6524","-2500","0","0","-2500","-20031",NA,"SRP/CAP EXCHANGE WATER",NA,NA,"TOTAL CUSTOMER DELIVERIES",2013
"51","WADDELL PUMPING","54064","89116","66664","209844","316","0","0","316","0","0","27530","27530","78545","80601","43033","202179","439869",NA,"WADDELL PUMPING",NA,NA,"TOTAL CUSTOMER DELIVERIES",2013
"52","WADDELL RELEASES","-24714","0","0","-24714","-34341","-20589","-78357","-133287","-94386","-87700","-371","-182457","0","0","0","0","-340458",NA,"WADDELL RELEASES",NA,NA,"TOTAL CUSTOMER DELIVERIES",2013
"53","COLORADO RIVER DIVERSIONS","81083","146057","178756","405896","150717","176183","130223","457123","84931","96915","149998","331844","187598","144410","137651","469659","1664522",NA,"COLORADO RIVER DIVERSIONS",NA,NA,"TOTAL CUSTOMER DELIVERIES",2013
"54","COLORADO RIVER ACTUAL","79888","146879","179730","406497","148444","174238","129487","452169","80301","95266","149252","324819","186039","143877","137866","467782","1651267",NA,"COLORADO RIVER ACTUAL",NA,NA,"TOTAL CUSTOMER DELIVERIES",2013
"55","TOTAL CUSTOMER DELIVERIES","54644","73683","123825","252152","164245","187340","194295","545880","183511","165587","114740","463838","110496","82300","71294","264090","1525960","-31","TOTAL CUSTOMER DELIVERIES",NA,NA,"TOTAL CUSTOMER DELIVERIES",2014
"56","TOTAL CANAL LOSSES","739","1283","2185","4207","2959","3425","3464","9848","3382","2663","2559","8604","2343","1892","1423","5658","28317",NA,"TOTAL CANAL LOSSES",NA,NA,"TOTAL CUSTOMER DELIVERIES",2014
"57","MWD LAKE STORAGE THRU T/O","0","1766","1290","3056","1125","1171","2262","4558","2262","1003","587","3852","1897","3570","1040","6507","17973",NA,"MWD LAKE STORAGE THRU T/O",NA,NA,"TOTAL CUSTOMER DELIVERIES",2014
"58","SRP/CAP EXCHANGE WATER","0","0","0","0","0","0","0","0","0","0","0","0","0","0","0","0","0",NA,"SRP/CAP EXCHANGE WATER",NA,NA,"TOTAL CUSTOMER DELIVERIES",2014
"59","WADDELL PUMPING","54111","52725","48127","154963","9835","1525","0","11360","0","0","27580","27580","5000","48000","40000","93000","286903",NA,"WADDELL PUMPING",NA,NA,"TOTAL CUSTOMER DELIVERIES",2014
"60","WADDELL RELEASES","-26551","0","0","-26551","-359","-9966","-64683","-75008","-93862","-67548","-5520","-166930","0","0","0","0","-268489",NA,"WADDELL RELEASES",NA,NA,"TOTAL CUSTOMER DELIVERIES",2014
"61","COLORADO RIVER DIVERSIONS","82943","129457","175427","387827","177805","183495","135338","496638","95293","101705","139946","336944","119736","135762","113757","369255","1590664",NA,"COLORADO RIVER DIVERSIONS",NA,NA,"TOTAL CUSTOMER DELIVERIES",2014
"62","COLORADO RIVER ACTUAL","84467","130265","176237","390969","177897","183603","133051","494551","92532","99382","140046","331960","119736","135762","113757","369255","1586735",NA,"COLORADO RIVER ACTUAL",NA,NA,"TOTAL CUSTOMER DELIVERIES",2014
"63","TOTAL CUSTOMER DELIVERIES","58728","77475","134316","270519","183305","146795","166051","496151","156931","165338","121912","444181","96557","63748","78053","238358","1449209","-132474","TOTAL CUSTOMER DELIVERIES",NA,NA,"TOTAL CUSTOMER DELIVERIES",2015
"64","TOTAL CANAL LOSSES","739","1283","2185","4207","2959","3425","3464","9848","3382","2663","2559","8604","2343","1892","1423","5658","28317",NA,"TOTAL CANAL LOSSES",NA,NA,"TOTAL CUSTOMER DELIVERIES",2015
"65","MWD LAKE STORAGE THRU T/O","0","2044","2721","4765","2559","799","2154","5512","1817","1892","2046","5755","1453","3127","1606","6186","22218",NA,"MWD LAKE STORAGE THRU T/O",NA,NA,"TOTAL CUSTOMER DELIVERIES",2015
"66","SRP/CAP EXCHANGE WATER","0","3886","0","3886","0","-8000","-7000","-15000","-1166","-2000","-720","-3886","0","0","-11","-11","-15011",NA,"SRP/CAP EXCHANGE WATER",NA,NA,"TOTAL CUSTOMER DELIVERIES",2015
"67","WADDELL PUMPING","115675","24605","11698","151978","1058","36939","375","38372","0","0","41077","41077","27691","48256","47232","123179","354606",NA,"WADDELL PUMPING",NA,NA,"TOTAL CUSTOMER DELIVERIES",2015
"68","WADDELL RELEASES","0","-260","-6159","-6419","-34505","-3516","-83579","-121600","-87950","-97320","-2011","-187281","-10146","0","0","-10146","-325446",NA,"WADDELL RELEASES",NA,NA,"TOTAL CUSTOMER DELIVERIES",2015
"69","COLORADO RIVER DIVERSIONS","175142","109033","144761","428936","155376","176442","81465","413283","73014","70573","164863","308450","117898","117023","128303","363224","1513893","2015 target","COLORADO RIVER DIVERSIONS",NA,NA,"TOTAL CUSTOMER DELIVERIES",2015
"70","COLORADO RIVER ACTUAL","180492","109441","146368","436301","154414","177030","77195","408639","70484","69587","167508","307579","115253","120080","130170","365503","1518022",NA,"COLORADO RIVER ACTUAL",NA,NA,"TOTAL CUSTOMER DELIVERIES",2015
"71","TOTAL CUSTOMER DELIVERIES","43148","77253","122146","242547","138443","166029","201550","506022","193428","151816","129194","474438","88804","57369","61730","207903","1430910","-89768","TOTAL CUSTOMER DELIVERIES",NA,NA,"TOTAL CUSTOMER DELIVERIES",2016
"72","TOTAL CANAL LOSSES","739","1283","2185","4207","2959","3425","3464","9848","3382","2663","2559","8604","2343","1892","1423","5658","28317",NA,"TOTAL CANAL LOSSES",NA,NA,"TOTAL CUSTOMER DELIVERIES",2016
"73","MWD LAKE STORAGE THRU T/O","0","2526","4089","6615","1608","2278","3295","7181","2560","948","2584","6092","3444","4424","1662","9530","29418",NA,"MWD LAKE STORAGE THRU T/O",NA,NA,"TOTAL CUSTOMER DELIVERIES",2016
"74","SRP/CAP EXCHANGE WATER","0","0","0","0","-4000","-6000","-4000","-14000","-2000","0","0","-2000","0","0","-11","-11","-16011",NA,"SRP/CAP EXCHANGE WATER",NA,NA,"TOTAL CUSTOMER DELIVERIES",2016
"75","WADDELL PUMPING","108452","32889","4539","145880","28044","12390","0","40434","0","0","19406","19406","40011","74729","52389","167129","372849",NA,"WADDELL PUMPING",NA,NA,"TOTAL CUSTOMER DELIVERIES",2016
"76","WADDELL RELEASES","0","0","-10501","-10501","0","0","-112673","-112673","-119947","-87736","-22496","-230179","-1165","0","0","-1165","-354518",NA,"WADDELL RELEASES",NA,NA,"TOTAL CUSTOMER DELIVERIES",2016
"77","COLORADO RIVER DIVERSIONS","152339","113951","122458","388748","167054","178122","91636","436812","77423","67691","131247","276361","133437","138414","117193","389044","1490965","2016 target","COLORADO RIVER DIVERSIONS",NA,NA,"TOTAL CUSTOMER DELIVERIES",2016
"78","COLORADO RIVER ACTUAL","155980","116971","122518","395469","168623","176141","88596","433360","74494","64682","133630","272806","133167","140485","117864","391516","1493151",NA,"COLORADO RIVER ACTUAL",NA,NA,"TOTAL CUSTOMER DELIVERIES",2016
"79","TOTAL CUSTOMER DELIVERIES","44141","49345","109644","203130","147631","147226","193124","487981","170239","162968","131170","464377","79636","54330","67861","201827","1357315","-163363","TOTAL CUSTOMER DELIVERIES",NA,NA,"TOTAL CUSTOMER DELIVERIES",2017
"80","TOTAL CANAL LOSSES","739","1283","2185","4207","2959","3425","3464","9848","3382","2663","2559","8604","2343","1892","1423","5658","28317",NA,"TOTAL CANAL LOSSES",NA,NA,"TOTAL CUSTOMER DELIVERIES",2017
"81","MWD LAKE STORAGE THRU T/O","0","960","3970","4930","71","2230","3740","6041","2096","985","3198","6279","3450","5218","1302","9970","27220",NA,"MWD LAKE STORAGE THRU T/O",NA,NA,"TOTAL CUSTOMER DELIVERIES",2017
"82","SRP/CAP EXCHANGE WATER","0","0","0","0","0","0","0","0","0","0","0","0","0","0","0","0","0",NA,"SRP/CAP EXCHANGE WATER",NA,NA,"TOTAL CUSTOMER DELIVERIES",2017
"83","WADDELL PUMPING","83310","16480","20055","119845","9498","24625","0","34123","0","0","9609","9609","44152","65541","70977","180670","344247",NA,"WADDELL PUMPING",NA,NA,"TOTAL CUSTOMER DELIVERIES",2017
"84","WADDELL RELEASES","-3647","-7866","-207","-11720","-6","-1492","-117578","-119076","-100321","-94421","-13817","-208559","0","0","-76","-76","-339431",NA,"WADDELL RELEASES",NA,NA,"TOTAL CUSTOMER DELIVERIES",2017
"85","COLORADO RIVER DIVERSIONS","124543","60202","135647","320392","160153","176014","82750","418917","75396","72195","132719","280310","129581","126981","141369","397931","1417550","2017 target","COLORADO RIVER DIVERSIONS",NA,NA,"TOTAL CUSTOMER DELIVERIES",2017
"86","COLORADO RIVER ACTUAL","126924","62359","136275","325558","159848","174612","79014","413474","71258","70184","134073","275515","130498","126715","143853","401066","1415613",NA,"COLORADO RIVER ACTUAL",NA,NA,"TOTAL CUSTOMER DELIVERIES",2017
"87","TOTAL CUSTOMER DELIVERIES","51650","68105","106974","226729","159041","171968","194930","525939","198498","174238","144139","516875","75004","74106","60577","209687","1479230","13500","TOTAL CUSTOMER DELIVERIES",NA,NA,"TOTAL CUSTOMER DELIVERIES",2018
"88","TOTAL CANAL LOSSES","739","1283","2185","4207","2959","3425","3464","9848","3382","2663","2559","8604","2343","1892","1423","5658","28317",NA,"TOTAL CANAL LOSSES",NA,NA,"TOTAL CUSTOMER DELIVERIES",2018
"89","MWD LAKE STORAGE THRU T/O","0","1245","1376","2621","2992","4839","3560","11391","3753","2162","3758","9673","742","4368","1362","6472","30157",NA,"MWD LAKE STORAGE THRU T/O",NA,NA,"TOTAL CUSTOMER DELIVERIES",2018
"90","SRP/CAP EXCHANGE WATER","0","0","0","0","0","0","-2984","-2984","-8893","6441","4836","2384","2905","10265","6","13176","12576",NA,"SRP/CAP EXCHANGE WATER",NA,NA,"TOTAL CUSTOMER DELIVERIES",2018
"91","WADDELL PUMPING","42045","51021","46045","139111","10279","4059","0","14338","0","0","17967","17967","94204","80702","79076","253982","425398",NA,"WADDELL PUMPING",NA,NA,"TOTAL CUSTOMER DELIVERIES",2018
"92","WADDELL RELEASES","-4721","-14510","-18985","-38216","-6618","-4883","-106895","-118396","-118035","-157144","-7983","-283162","0","-109","0","-109","-439883",NA,"WADDELL RELEASES",NA,NA,"TOTAL CUSTOMER DELIVERIES",2018
"93","COLORADO RIVER DIVERSIONS","89713","107144","137595","334452","168653","179408","92075","440136","78705","28360","165276","272341","175198","171224","142444","488866","1535795",NA,"COLORADO RIVER DIVERSIONS",NA,NA,"TOTAL CUSTOMER DELIVERIES",2018
"94","COLORADO RIVER ACTUAL","90163","109197","138939","338299","168400","178154","87984","434538","71609","21609","164209","257427","175602","173266","143241","492109","1522373",NA,"COLORADO RIVER ACTUAL",NA,NA,"TOTAL CUSTOMER DELIVERIES",2018
"95","TOTAL CUSTOMER DELIVERIES","42078","50313","82174","174565","143255","140285","183443","466983","188724","181776","124651","495151","103093","23617","48082","174792","1311491","13500","TOTAL CUSTOMER DELIVERIES",NA,NA,"TOTAL CUSTOMER DELIVERIES",2019
"96","TOTAL CANAL LOSSES","739","1283","2185","4207","2959","3425","3464","9848","3382","2663","2559","8604","2343","1892","1423","5658","28317",NA,"TOTAL CANAL LOSSES",NA,NA,"TOTAL CUSTOMER DELIVERIES",2019
"97","MWD LAKE STORAGE THRU T/O","0","55","1056","1111","1915","2784","2521","7220","2267","2783","1859","6909","2787","2962","659","6408","21648",NA,"MWD LAKE STORAGE THRU T/O",NA,NA,"TOTAL CUSTOMER DELIVERIES",2019
"98","SRP/CAP EXCHANGE WATER","0","0","-2608","-2608","2028","3526","80","5634","-3173","-8011","-1070","-12254","2064","-6509","-2166","-6611","-15839",NA,"SRP/CAP EXCHANGE WATER",NA,NA,"TOTAL CUSTOMER DELIVERIES",2019
"99","WADDELL PUMPING","62928","99729","62","162719","11000","18293","1475","30768","0","29","31893","31922","39398","102175","25914","167487","392896",NA,"WADDELL PUMPING",NA,NA,"TOTAL CUSTOMER DELIVERIES",2019
"100","WADDELL RELEASES","-18404","0","-127","-18531","-13494","-15508","-84160","-113162","-93396","-75286","0","-168682","0","-1783","0","-1783","-302158",NA,"WADDELL RELEASES",NA,NA,"TOTAL CUSTOMER DELIVERIES",2019
"101","COLORADO RIVER DIVERSIONS","87341","151380","82742","321463","147663","152805","106823","407291","97804","103954","159892","361650","149685","122354","73912","345951","1436355",NA,"COLORADO RIVER DIVERSIONS",NA,NA,"TOTAL CUSTOMER DELIVERIES",2019
"102","COLORADO RIVER ACTUAL","90530","150723","82674","323927","143769","153751","103850","401370","92195","101771","160158","354124","151035","125435","73912","350382","1429803",NA,"COLORADO RIVER ACTUAL",NA,NA,"TOTAL CUSTOMER DELIVERIES",2019
"103","TOTAL CUSTOMER DELIVERIES","52807","69398","88013","210218","141711","174457","192700","508868","185936","180706","129353","495995","92903","56798","60059","209760","1424841",NA,"TOTAL CUSTOMER DELIVERIES",NA,NA,"TOTAL CUSTOMER DELIVERIES",2020
"104","TOTAL CANAL LOSSES","739","1283","2185","4207","2959","3425","3464","9848","3382","2663","2559","8604","2343","1892","1423","5658","28317",NA,"TOTAL CANAL LOSSES",NA,NA,"TOTAL CUSTOMER DELIVERIES",2020
"105","MWD LAKE STORAGE THRU T/O","0","883","640","1523","618","1718","2967","5303","3280","2626","2888","8794","6084","4262","1870","12216","27836",NA,"MWD LAKE STORAGE THRU T/O",NA,NA,"TOTAL CUSTOMER DELIVERIES",2020
"106","SRP/CAP EXCHANGE WATER","0","0","454","454","2393","12158","-5139","9412","-5004","-1676","0","-6680","0","0","0","0","3186",NA,"SRP/CAP EXCHANGE WATER",NA,NA,"TOTAL CUSTOMER DELIVERIES",2020
"107","WADDELL PUMPING","20718","2716","23196","46630","3618","0","0","3618","0","5","33393","33398","61538","65150","77761","204449","288095",NA,"WADDELL PUMPING",NA,NA,"TOTAL CUSTOMER DELIVERIES",2020
"108","WADDELL RELEASES","0","0","-19258","-19258","0","-12620","-87156","-99776","-112890","-121200","-3227","-237317","-23","-5290","0","-5313","-361664",NA,"WADDELL RELEASES",NA,NA,"TOTAL CUSTOMER DELIVERIES",2020
"109","COLORADO RIVER DIVERSIONS","74264","74280","95230","243774","151299","179138","106836","437273","74704","63124","164966","302794","162845","122812","141113","426770","1410611",NA,"COLORADO RIVER DIVERSIONS",NA,NA,"TOTAL CUSTOMER DELIVERIES",2020
"110","COLORADO RIVER ACTUAL","75318","74716","94056","244090","148297","179746","103316","431359","69322","61464","164300","295086","163523","123148","145331","432002","1402537",NA,"COLORADO RIVER ACTUAL",NA,NA,"TOTAL CUSTOMER DELIVERIES",2020
"111","TOTAL CUSTOMER DELIVERIES","48857","72561","106302","227720","152003","173515","194773","520291","138016","121001","109841","368858","80399","54679","71505","206583","1323452",NA,"TOTAL CUSTOMER DELIVERIES",NA,NA,"TOTAL CUSTOMER DELIVERIES",2021
"112","TOTAL CANAL LOSSES","739","1283","2185","4207","2959","3425","3464","9848","3382","2663","2559","8604","2343","1892","1423","5658","28317",NA,"TOTAL CANAL LOSSES",NA,NA,"TOTAL CUSTOMER DELIVERIES",2021
"113","MWD LAKE STORAGE THRU T/O","0","1500","3973","5473","2121","2837","3311","8269","1027","1135","2874","5036","3089","4475","2020","9584","28362",NA,"MWD LAKE STORAGE THRU T/O",NA,NA,"TOTAL CUSTOMER DELIVERIES",2021
"114","SRP/CAP EXCHANGE WATER","-2","0","3015","3013","4981","4060","-8114","927","-6021","2362","1","-3658","-161","-4569","-6162","-10892","-10610",NA,"SRP/CAP EXCHANGE WATER",NA,NA,"TOTAL CUSTOMER DELIVERIES",2021
"115","WADDELL PUMPING","71569","35134","33356","140059","2171","262","0","2433","998","0","608","1606","53433","66963","17046","137442","281540",NA,"WADDELL PUMPING",NA,NA,"TOTAL CUSTOMER DELIVERIES",2021
"116","WADDELL RELEASES","0","0","-437","-437","-1292","-16465","-103469","-121226","-80046","-76446","-8333","-164825","0","0","0","0","-286488",NA,"WADDELL RELEASES",NA,NA,"TOTAL CUSTOMER DELIVERIES",2021
"117","COLORADO RIVER DIVERSIONS","121163","110478","148394","380035","162943","167634","89965","420542","57356","50715","107550","215621","139103","123440","85832","348375","1364573",NA,"COLORADO RIVER DIVERSIONS",NA,NA,"TOTAL CUSTOMER DELIVERIES",2021
"118","COLORADO RIVER ACTUAL","123894","111176","148654","383724","163175","167846","86402","417423","51780","48306","106368","206454","138794","124347","85832","348973","1356574",NA,"COLORADO RIVER ACTUAL",NA,NA,"TOTAL CUSTOMER DELIVERIES",2021
